#######################################
# Syntax Coloring Map For VFD Control
#######################################

# Classes (value = KEYWORD1)
VFD	KEYWORD1
SchneiderATV12	KEYWORD1
SiemensV20	KEYWORD1
WEGCFW500	KEYWORD1
ABBACS550	KEYWORD1
DanfossFC302	KEYWORD1
YaskawaV1000	KEYWORD1

# Methods and Functions (value = KEYWORD2)
setMotorSpeed	KEYWORD2
setMotorDirection	KEYWORD2
sendCommandWithRetry	KEYWORD2
readFrequencyLimits	KEYWORD2
readMotorStatus	KEYWORD2
getMotorSpeed	KEYWORD2
getMotorStatus	KEYWORD2
getMotorErrors	KEYWORD2
getMotorDirection	KEYWORD2
getMinFrequency	KEYWORD2
getMaxFrequency	KEYWORD2
getHighSpeed	KEYWORD2

# Constants (value = LITERAL1)
STATE_NOT_READY	LITERAL1
STATE_SWITCH_DISABLED	LITERAL1
STATE_READY	LITERAL1
STATE_SWITCHED_ON	LITERAL1
STATE_OPERATION_ENABLED	LITERAL1
STATE_FAULT	LITERAL1
CMD_SHUTDOWN	LITERAL1
CMD_SWITCH_ON	LITERAL1
CMD_RESET_FAULT	LITERAL1
CMD_DISABLE_OPERATION	LITERAL1
CMD_RUN_FORWARD	LITERAL1
CMD_RUN_REVERSE	LITERAL1